 HHHH  HHHHH
HH  H  H   H
H B HHHHB  H
H  BDDDD B H
HH    H W HH
 HHHHHHHHH
