 HHHHHHH
 HDDDD H
HHHDDDBHHH
H  BHB B H
H BB  HB H
H    H   H
HHHH W HHH
   HHHHH