        HHHHHHH
    HHHHH  H  HHHH
    H   H   B    H
 HHHH HBB HH HH  H
HH      H H  HH HHH
H  HHH BHB  B  B  H
HDDD    H HH  H   H
HDDDH    W H HHH HH
HDDDH  HHH  B  B  H
HHHHHHHH HH   H   H
          HHHHHHHHH
