HHHHHHHHHHHH
HH     HH  H
HH   B   B H
HHHH HH BB H
H   B H    H
H BBB H HHHH
H   H H B HH
H  H  H  B H
H BH BH    H
H   DDH HHHH
HHHHDD B HWH
HDDDDDH BH H
HHDDDDH  B H
HHHDDHH    H
HHHHHHHHHHHH
