        HHHHH
        HDDDH
        HDDDHHHHHHHHH
 HHHHH  HDDDB       H 
 H   HHHHD DHHHHBB  H
 HB     HDDDH  H  BHH
 H  HHH HDHHHB H   H 
 H HH   HW  B  HHH HH
 H H  H H HH   H    H
HH HB B HB HHH H B  H
H   B HHH     B  B  H
H  H       HHHHHH  HH
HHBH HHH  HH    HHHH
 H   H HHHH
 HHHHH
