HHHH HHHH
H  HHH  H
H    B  H
H  H H  H
HH H HBHH
H  HDH  H
H  CDC WH
H  HDH HH
HHHH   H
   H HBH
   H   H
   HHHHH
